397 397 397 397 397 397 397 397 397 397 397 397 397 397 397 397 
1 1 1 1 1 1 1 1 1 1 1 1 1 1 1 1 
1 1 1 649 650 651 652 653 654 655 656 657 491 492 1 1 
1 491 492 677 678 679 680 681 682 683 684 685 686 687 1 1 
1 1 704 705 706 707 708 709 710 711 712 713 714 715 1 1 
496 1 732 733 734 735 736 737 738 739 740 741 742 743 1 1 
1 1 760 761 762 763 764 765 766 767 768 769 770 771 1 1 
1 1 788 789 790 791 792 793 794 795 796 797 798 799 248 249 
1 1 816 817 818 819 820 821 822 823 824 825 826 827 276 277 
582 583 584 585 1 1 1 1 1 1 1 1 302 303 304 305 
610 611 612 613 425 426 427 428 429 430 431 1 330 331 332 333 
638 639 640 641 453 454 455 456 457 458 459 1 358 359 360 361 
666 667 668 669 481 482 483 484 485 486 487 1 386 387 388 389 
563 564 565 566 567 568 569 570 571 572 573 574 575 576 577 578 
591 592 593 594 595 596 597 598 599 600 601 602 603 604 605 606